[0][0][1,3][0][0][0][1][1,4][1][0][7][1][1][1][1]
[0][0][1][1][1][0][1][0][1][0][1][0,2][0][0][1]
[0][1][1][0][1][0][1][0][1][0][1][0][0][0][1]
[0][1][0][0][1][0][1][0][1][0][1][0][0][0][1]
[0][1][0][1][1][0][1][1][1][1,5][1][0][0][0][1]
[0][1][0][0][0][0][1][0][1][0][0][0][0][0][1]
[0][1][1][0][0][0][1][0][1][0][0][0][0][0][1]
[0][0][1][1][1][1][1][1][1][0][0][0][0][0][1]
[0][0][0][0][1][0][1][0][0][0][0][0][0][0][1]
[0][0][0][0][1][1][1][1][1][1][1][1][1][1][1]
